000000000000000000000000000000000000000000000000000000000000000000000000000000000000000000000000000000000000000000000000000000000000000000000000000000
0____________________________________________________________________________________________________________________________________________________0
0____________________________________________________________________________________________________________________________________________________0
0____________________________________________________________________________________________________________________________________________________0
0____________________________________________________________________________________________________________________________________________________0
0____________________________________________________________________________________________________________________________________________________0
0____________________________________________________________________________________________________________________________________________________0
0____________________________________________________________________________________________________________________________________________________0
0____________________________________________________________________________________________________________________________________________________0
0____________________________________________________________________________________________________________________________________________________0
0____________________________________________________________________________________C_______________________________________________________________0
0___________________C__________________________________C___________________C_________________________________________________________________________0
0______________________________________C_______________________________________kk____________________________________________________________________0
0_____________________________________________________________________________k__k____k____k_________________________________________________________0
0______________________C______________________________________________________k______kkk__kkk________________________________________________________0
0_______________________________________________________________________P_____k_______k____k_________________________________________________________0
0______________________________________________________________________PP_____k__k___________________________________________________________________0
0_____________________________________________________________________PPP______kk____________________________________________________________________0
0____________________PPPPP___________________________________________PPPP____________________________________________________________________________0
0______________________________________T0___________________________PPPPP____________________________________________________________________________0
0______________________________________00______________T0__________PPPPPP_______________________________G____________________________________________0
0___________P____P_______P_____________00______________00_________PPPPPPP____________________________________________________________________________0
PPPPPPPPPPPPPPPPPPPPPPPPPPPPPPPPPPPPPPPPPPPPPPPPPPPPPPPPPPPPPPPPPPPPPPPPPPPPPPPPPPPPPPPPPPPPPPPPPPPPPPPPPPPPPPPPPPPPPPPPPPPPPPPPPPPPPPPPPPPPPPPPPPPPPP
PPPPPPPPPPPPPPPPPPPPPPPPPPPPPPPPPPPPPPPPPPPPPPPPPPPPPPPPPPPPPPPPPPPPPPPPPPPPPPPPPPPPPPPPPPPPPPPPPPPPPPPPPPPPPPPPPPPPPPPPPPPPPPPPPPPPPPPPPPPPPPPPPPPPPP
PPPPPPPPPPPPPPPPPPPPPPPPPPPPPPPPPPPPPPPPPPPPPPPPPPPPPPPPPPPPPPPPPPPPPPPPPPPPPPPPPPPPPPPPPPPPPPPPPPPPPPPPPPPPPPPPPPPPPPPPPPPPPPPPPPPPPPPPPPPPPPPPPPPPPP